8 2 1 11 12 6 9 14 11 3 0 0 8 8 2 10 14 14 12 13 6 11 10 3 3 12 2 3 5 7 12 2 12 9 13 12 4 14 7 11 13 7 6 7 11 10 7 0 14 11 
0 2 3 10 3 8 8 14 10 10 1 9 4 6 1 7 8 7 11 2 10 12 13 3 4 3 13 0 7 1 0 1 6 1 6 2 6 11 3 1 12 3 8 3 7 7 9 12 1 8 
2 14 6 14 2 11 4 5 12 11 0 5 1 12 4 1 0 10 14 13 4 7 2 12 2 12 12 14 3 6 11 2 2 11 2 2 6 9 7 4 9 6 10 9 3 13 9 10 6 3 
5 14 1 6 6 14 4 13 4 9 5 10 6 1 4 2 11 8 9 12 3 5 8 13 0 3 3 12 5 12 2 13 7 5 1 11 1 10 12 11 2 1 2 5 9 13 13 1 3 2 
11 4 14 1 10 7 0 8 6 3 1 3 10 8 14 1 3 10 11 3 10 9 14 3 12 1 5 1 4 14 3 8 12 9 4 12 11 13 7 7 10 0 4 3 2 14 6 11 13 2 
0 14 11 0 8 3 3 14 3 5 9 10 14 10 4 0 2 1 8 13 13 10 4 11 9 8 0 1 13 9 7 12 12 7 11 8 7 2 6 14 1 8 14 12 5 2 2 13 10 14 
0 6 5 4 10 8 14 5 11 0 8 5 9 1 8 6 5 0 8 5 1 10 1 8 7 14 6 11 9 8 0 13 6 4 14 3 7 8 10 4 7 14 4 14 11 13 2 8 13 4 
1 10 11 9 7 11 14 0 11 0 9 9 9 4 0 9 7 14 1 1 3 11 14 4 11 1 11 6 13 5 1 8 7 0 12 11 0 3 5 3 9 1 0 3 4 11 14 2 12 3 
9 2 6 2 0 11 6 8 4 14 13 11 9 0 3 9 1 1 2 5 12 4 8 13 1 5 14 13 5 10 10 2 11 4 7 11 10 12 2 5 7 0 13 2 4 6 5 13 3 5 
6 7 12 0 7 13 12 14 8 9 14 3 14 1 12 3 13 12 3 7 1 12 3 10 0 13 11 3 4 4 6 5 8 10 6 8 9 7 6 9 4 7 10 3 7 9 10 3 8 4 
5 14 6 4 14 7 6 1 12 7 1 13 3 8 12 14 9 2 11 0 0 3 0 11 11 3 7 2 7 8 12 6 14 11 7 6 11 14 2 0 13 0 7 7 7 14 0 3 4 3 
7 7 14 4 4 8 9 1 5 5 6 13 10 3 2 0 1 10 3 9 12 12 13 1 6 2 9 7 13 8 4 10 13 0 4 6 14 9 14 14 11 9 8 0 6 13 9 4 6 13 
12 2 7 10 9 12 0 12 7 10 0 13 2 14 13 14 7 6 12 3 2 8 8 12 2 3 4 13 4 14 7 9 8 6 13 2 4 9 3 13 6 13 14 14 2 10 0 11 3 7 
7 2 1 1 6 6 12 7 5 5 1 1 9 9 7 0 8 12 10 11 3 1 2 3 11 10 1 0 1 13 5 6 7 0 5 12 2 5 8 9 5 9 7 5 7 11 5 5 5 7 
14 7 9 3 8 12 4 7 9 12 11 10 14 12 9 4 8 12 11 12 3 8 2 5 8 8 5 4 3 9 2 5 8 4 5 5 7 14 8 3 4 5 0 2 11 9 5 6 5 4 
3 6 0 12 14 8 1 9 12 10 11 14 11 8 14 9 14 14 9 4 5 7 0 5 12 14 10 2 0 8 10 10 13 9 1 12 3 0 9 4 3 1 2 4 5 4 7 10 11 10 
0 3 1 5 10 3 14 7 12 0 5 10 9 2 5 13 14 5 8 10 3 6 9 6 3 8 2 4 13 7 3 9 10 6 2 12 1 9 4 8 1 4 5 2 1 9 4 0 3 10 
1 13 5 12 5 14 4 12 5 4 1 6 8 8 4 14 12 10 7 9 13 13 6 1 6 13 9 10 7 4 13 14 5 13 6 14 4 7 6 14 1 10 5 3 5 8 14 10 10 2 
6 13 8 10 4 11 7 9 13 6 2 11 8 2 4 12 7 13 3 7 1 0 4 9 8 11 4 12 6 2 10 3 11 7 4 0 10 9 8 6 8 1 12 6 12 5 7 3 12 6 
1 11 13 14 4 0 0 8 12 13 12 7 13 12 7 14 13 6 0 12 13 0 5 14 5 14 10 13 10 12 10 8 7 11 5 4 10 3 7 10 6 4 3 14 13 1 6 2 12 12 
1 14 2 1 2 12 6 12 13 8 13 13 13 2 11 1 14 13 14 4 2 9 2 9 12 4 16 12 9 8 11 14 2 11 4 5 6 8 1 8 0 6 8 8 6 8 9 7 0 3
10 3 12 12 3 8 9 7 9 12 8 6 9 1 14 12 9 12 13 8 0 10 9 7 3 14 0 9 11 7 11 13 11 12 3 1 2 12 2 7 2 2 4 1 7 14 11 11 10 2 
9 2 0 13 11 8 8 6 13 12 1 9 4 0 14 10 13 14 13 11 2 6 12 1 0 1 0 9 1 4 10 13 6 0 8 5 5 3 9 1 14 9 9 11 10 9 14 3 4 14 
14 0 14 1 12 8 9 12 9 13 3 6 14 14 5 11 11 5 4 4 14 13 2 12 1 11 6 10 7 14 11 1 12 11 1 7 5 4 8 4 2 14 13 0 14 14 3 6 0 13 
14 9 0 0 8 0 1 13 1 9 8 13 12 13 1 2 0 14 10 7 1 12 2 10 12 0 14 4 4 12 11 5 1 0 8 2 12 10 12 7 4 7 4 8 4 11 4 0 0 6 
4 12 3 9 10 4 5 5 9 10 10 6 0 2 5 3 13 14 11 4 6 11 1 5 3 9 1 2 8 12 7 13 5 1 0 14 4 9 10 11 8 13 0 14 10 8 11 13 12 6
18 10 14 11 6 5 9 12 8 8 2 10 6 0 0 6 4 12 3 2 12 11 8 5 4 11 0 17 13 12 18 13 1 2 6 3 13 7 0 10 1 6 5 10 12 11 0 3 3 3
13 13 10 0 0 6 4 6 8 3 14 12 1 8 12 2 6 11 14 9 13 6 9 7 10 13 2 13 5 11 4 13 12 14 1 12 0 5 2 12 7 2 4 11 4 1 11 3 0 4 
13 4 12 5 2 9 5 8 13 8 14 2 1 11 13 13 6 6 12 12 3 0 2 12 2 1 12 4 14 14 7 14 1 7 7 0 4 4 10 8 7 2 12 8 4 10 2 12 4 3 
1 11 13 5 9 0 9 5 0 6 5 8 3 4 5 1 12 0 10 13 13 7 1 12 3 0 1 1 9 3 10 5 4 8 14 1 8 13 8 3 7 4 5 14 0 8 6 1 10 2 
4 2 8 6 7 4 6 0 13 14 7 1 10 14 0 1 2 7 1 1 0 14 2 2 2 12 1 9 8 4 9 13 3 11 3 6 2 5 1 10 0 9 11 13 13 3 5 2 11 4 
11 3 14 7 8 1 7 7 12 8 12 6 6 6 6 5 8 13 11 5 13 14 7 13 10 6 13 13 3 5 0 11 13 2 4 3 5 4 14 5 7 3 3 0 3 8 11 0 7 0 
6 10 14 3 14 1 4 1 13 7 11 9 2 6 14 14 13 6 2 8 13 8 3 7 4 11 8 3 5 1 6 8 11 9 13 6 6 13 10 6 8 1 0 0 1 9 8 5 7 10 
10 10 11 9 13 14 14 0 0 2 9 1 9 12 3 11 8 9 9 3 3 2 6 8 7 12 14 0 4 5 10 4 14 11 7 4 2 8 1 8 0 9 9 13 5 1 13 9 5 10 
6 4 3 11 10 11 10 7 5 10 14 9 11 7 1 10 12 10 3 13 12 3 4 4 3 2 12 5 1 4 5 7 7 12 5 8 14 10 6 6 2 1 12 11 10 12 11 2 6 3 
0 5 0 13 5 12 4 12 14 9 1 6 6 0 1 1 2 8 9 0 14 4 3 5 3 9 6 1 5 10 14 1 9 6 2 2 2 11 12 7 7 13 9 12 2 7 14 1 10 7 
5 8 4 13 0 0 11 10 4 9 9 9 7 14 10 5 4 4 6 2 9 2 12 11 13 11 10 10 12 1 9 4 4 12 14 12 14 2 5 0 13 0 14 3 14 8 14 1 9 9 
6 10 2 6 14 9 11 10 8 11 0 6 7 6 14 14 10 11 11 2 4 2 12 0 9 3 13 2 9 13 10 0 9 8 0 1 13 6 3 9 12 0 14 0 10 0 8 4 0 14 
9 10 12 3 4 3 11 1 2 8 9 8 11 13 1 14 4 8 7 0 2 4 4 4 2 13 14 0 9 7 4 6 3 8 4 5 1 10 1 14 3 13 9 9 3 1 14 13 0 14 
4 14 6 0 13 7 6 2 6 4 7 14 10 13 2 3 8 6 9 0 9 3 7 13 7 13 11 5 2 14 1 2 8 13 13 12 6 9 2 3 7 8 3 4 5 8 5 4 0 13 
0 11 2 11 12 14 4 10 14 12 6 1 2 14 6 12 8 1 6 11 0 12 1 3 2 1 4 8 6 10 9 11 14 3 5 0 8 6 13 7 13 11 13 3 11 12 3 2 5 1 
5 8 10 8 1 11 12 11 0 9 9 11 10 4 6 7 5 0 10 6 6 3 14 8 5 5 4 4 3 14 2 1 5 4 3 5 14 1 12 10 12 10 2 2 11 11 0 0 7 6 
7 1 4 12 4 9 9 8 14 13 5 6 1 1 8 12 7 4 7 14 8 9 10 13 2 9 3 3 8 3 8 13 10 4 13 7 9 1 8 8 12 12 14 10 4 11 13 9 1 8 
0 6 7 12 8 2 10 12 5 10 1 14 2 6 10 8 0 7 4 11 0 5 5 14 2 3 10 12 12 13 11 8 2 9 0 12 11 3 0 3 6 11 9 8 0 13 12 2 6 11 
6 14 0 4 1 3 8 14 10 9 13 4 4 3 9 13 8 9 3 5 11 2 3 9 0 6 14 7 7 9 0 9 10 5 13 6 1 3 3 4 8 5 14 3 6 3 10 12 7 12 
6 10 4 6 10 2 8 1 10 6 9 9 7 7 3 8 13 1 10 11 3 4 2 3 2 2 1 14 6 14 11 6 0 5 1 0 3 2 6 5 3 13 9 5 0 4 4 14 11 11 
8 2 1 11 4 3 6 7 2 13 12 13 5 9 0 9 7 0 13 6 4 3 4 10 8 3 10 11 8 8 10 7 14 3 10 14 8 14 1 1 7 9 14 13 0 5 6 6 12 9 
12 8 8 14 2 9 11 7 5 7 7 1 1 0 9 13 11 14 2 13 12 0 12 12 7 11 3 9 8 0 8 12 1 8 11 7 9 10 6 0 4 6 5 0 12 0 5 4 8 5 
2 10 14 12 7 10 7 7 3 14 10 9 10 2 1 8 6 4 13 11 5 12 14 10 10 10 13 1 11 5 0 4 7 1 9 11 11 3 11 14 7 13 2 3 12 12 2 6 1 10 
1 10 3 10 6 12 13 5 2 1 5 2 10 8 0 8 2 6 1 3 2 14 11 8 7 1 6 8 6 3 10 6 10 5 8 4 5 4 0 3 4 2 2 6 3 2 4 7 0 11
